{
    "其他": 0,
    "语文": 1,
    "数学": 2,
    "英语": 3,
    "物理": 4,
    "化学": 5,
    "生物": 6,
    "历史": 7,
    "地理": 8,
    "政治": 9
}